6x7
XXXXXXX
X...X.X
XX.X..X
E...X.G
X.....X
XXXXXXX
